9,9,1,1
11,11,11,11,11,11,11,11,11
11,6,5,5,5,5,5,3,11
11,2,9,9,9,9,9,4,11
11,2,9,9,9,9,9,4,11
11,2,9,9,9,9,9,4,11
11,2,9,9,9,12,9,4,11
11,2,11,9,9,9,9,4,11
11,10,7,7,7,7,7,8,11
11,11,11,11,11,11,11,11,11