9,9,1,1
11,11,11,11,11,11,11,11,11
11,6,2,2,2,2,2,10,11
11,5,9,9,9,9,9,7,11
11,5,9,9,9,9,9,7,11
11,5,9,9,9,9,9,7,11
11,5,9,13,9,12,9,7,11
11,5,9,9,9,9,9,7,11
11,3,4,4,4,4,4,8,11
11,11,11,11,11,11,11,11,11